NO ./Textures/north.xpm
SO ./Textures/south.xpm
WE ./Textures/west.xpm
EA ./Textures/east.xpm

C 50,50,50
F 164,169,20

111111111111111111111111111111111111111111
101000001000000000001111111111111111111111
101010101011111110001111111111111111111111
100010100010000010001111111111111111111111
111110101111101011101111111111111111111111
100000101000101000001111111111111111111111
101111101011101111111111111111111111111111
101000001010100000101111111111111111111111
101011111010111110101111111111111111111111
101010001010100010101111111111111111111111
101110101010101010101111111111111111111111
100000101010001010001111111111111111111111
111111101011111011101111111111111111111111
100000101000100010001111111111111111111111
101110101110101110111111111111111111111111
101000100000100010101111111111111111111111
101011111111111010101111111111111111111111
100010000000000010001111111111111111111111
101010111011111111101111111111111111111111
1N1000001000000000001111111111111111111111
111111111111111111111111111111111111111111

